6
5
3	1	3	1	3
1	0	1	0	1
3	1	3	1	3
1	0	0	0	1
2	4	5	0	1
3	1	2	1	3