11
10
0 0 0 0 0 0 0 0 0 0
0 0 0 1 1 1 1 0 0 0
0 0 4 1 0 0 1 0 0 0
0 0 0 1 0 4 1 5 0 0
0 0 0 1 0 0 1 5 0 0
0 0 0 1 0 0 1 0 0 0
0 0 0 1 0 0 1 0 0 0
0 0 14 1 0 0 1 3 0 0
0 1 1 1 1 1 1 1 1 0
0 0 12 0 0 12 0 12 0 0
0 0 0 0 0 0 0 0 0 0