11
10
0 0 0 0 0 0 0 0 0 0
0 0 0 6 1 1 6 0 0 0
0 0 3041 1 0 0 1 0 0 0
0 0 0 1 0 3022 1 3019 0 0
0 0 0 1 0 3024 1 3018 0 0
0 0 0 1 0 0 1 0 0 0
0 0 0 1 0 0 1 0 0 0
0 0 14 1 0 0 1 3016 0 0
0 1 1 6 1 1 6 1 1 0
0 0 12 0 0 12 0 12 0 0
0 0 0 0 0 0 0 0 0 0